WWWWWWWWWW
W........W
WWWWWWWWWW
W........W
WWWWWWWWWW
W..PC.T..W
WWWWWWWWWW
W........W
W........W
WWWWWWWWWW