___WWWW
WWWW.pW
W..W..W
W.CW..W
W..C..W
W....TW
WWWWWWW