WWWWWWWWWW
W....WWWWW
W..W.C.WWW
W...X..WWW
W...WW.WWW
W..X.PTWWW
WWWWWWWWWW
WWWWWWWWWW
WWWWWWWWWW
WWWWWWWWWW