WWWWWW_
W....WW
W.W.C.W
W..X..W
W..WW.W
W.X.PTW
WWWWWWW