WWW____
WpW_WWW
W.WWWTW
W.....W
W.CWC.W
WW....W
_WWWWWW