WWW____
WPWW___
W.TWWWW
W...C.W
W..W..W
W....WW
WWWWWWW