WWWWWWW
WT....W
W.C.C.W
WWWpW.W
W...C.W
W.T...W
WWWWWWW