WWWWWWWWWW
WXXXXXXXXW
WWWWWWWWWW
W...X.X..W
WWWWWWWWWW
W.P.C.T..W
WWWWWWWWWW
W.X....X.W
W...XX...W
WWWWWWWWWW