_______
WWWWWWW
WP....W
W.CC.TW
W..T..W
WWWWWWW
_______